3131414242512
2   3   1   2
4           4
3   1   2   1
4   1    3  1
1       2  31
24234       4
1          31
2  5  5    1
3  5  5    4
1214551311534